SO ./assets/rat.xpm
C 255,255,255
F 255,255,255
D ./assets/door.xpm
E 5,3 ./assets/ship2.obj ./assets/rat.xpm


WE ./assets/so.xpm
NO ./assets/w.xpm
EA ./assets/tex.xpm
FT ./assets/no_highres.xpm
CT ./assets/normal.xpm

1111111111111111111111111
1000000000100000000000001
1000000001110011111000001
10000000000000000|000000111111111
100000000000000001110000000000001
10N000000000000001110111111111111
1111-111111110000000000000001
11110111111110000000000000001
10000000000000000000000000001
10000000100000000100000000001
1000L000000000000000000000001
10000001110000011100000000001
10000001 1000001 100000000001
11111111 1111111 111111111111